28 28 28 28 28 28 28 28 28 28 28 28 28 28 28 28 28 28 28 28 28 28 28 28 28 28 28 28 28 28 28 28 28 28 28 28 28 28 28 28 28 28 28 28 28 28 28 28 28 28 28 28 28 28 28 28 28 28 28 28 28 28 28 28 28 28 28 28 28 28 28 28 28 28 28 28 28 28 28 28 28 28 28 28 28 28 28 28 28 28 28 28 28 28 28 28 28 28 28 28
28 28 28 28 28 28 28 28 28 28 28 28 28 28 28 28 28 28 28 28 28 28 29 28 28 28 28 28 28 28 28 28 28 28 28 28 28 28 28 28 28 28 28 28 28 28 28 28 28 28 28 28 28 28 28 28 28 28 28 28 28 28 28 28 28 28 28 28 28 28 28 28 28 28 28 28 28 28 28 28 28 28 28 28 28 28 28 28 28 28 28 28 28 28 28 28 28 28 28 28
28 28 28 28 28 28 28 28 28 28 28 28 28 28 28 28 28 28 28 28 28 28 28 28 28 28 28 28 29 28 28 28 28 28 28 28 28 28 29 28 28 28 28 28 28 28 28 28 28 28 28 28 28 28 28 28 28 28 28 28 28 28 28 28 28 28 28 28 28 28 28 28 28 28 28 28 28 28 28 28 28 28 28 28 28 28 28 28 28 28 28 28 28 28 28 28 28 28 28 28
28 28 28 28 28 28 28 28 28 28 28 28 28 28 28 28 28 28 28 28 28 28 28 28 28 28 28 28 28 28 28 28 28 28 28 28 28 28 28 28 28 28 28 28 28 28 28 28 28 28 28 28 28 28 28 28 28 28 28 28 28 28 28 28 28 28 28 28 28 28 28 28 28 28 28 28 28 28 28 28 28 28 28 28 28 28 28 28 28 28 28 28 28 28 28 28 28 28 28 28
28 28 28 28 28 28 28 28 28 28 28 28 28 28 28 28 28 28 28 28 28 28 28 28 28 28 28 28 28 28 28 28 28 28 28 28 28 28 28 28 28 28 28 28 28 28 28 28 28 28 28 28 28 28 28 28 28 28 28 28 28 28 28 28 28 28 28 28 28 28 28 28 28 28 28 28 29 29 28 28 28 28 28 28 28 28 28 28 28 28 28 28 28 28 28 28 28 28 28 28
28 28 28 28 28 28 28 28 28 28 28 28 28 28 28 29 28 28 28 28 28 28 28 28 28 28 28 28 28 28 28 28 28 28 28 28 28 28 28 28 28 28 28 28 28 28 28 28 28 28 28 29 28 28 28 28 28 28 28 28 28 28 28 28 28 28 28 28 28 28 28 28 28 28 28 28 28 28 28 28 28 28 28 28 28 28 28 28 28 28 28 28 28 28 28 28 28 28 28 28
28 28 28 28 28 28 28 38 36 36 36 36 36 36 36 36 36 36 36 36 36 36 36 36 36 36 36 36 36 36 36 36 36 36 36 36 36 36 36 36 36 36 36 36 36 36 36 36 36 36 36 36 36 36 36 36 36 36 36 36 36 36 36 36 36 36 36 36 36 36 36 36 36 36 36 36 36 36 36 36 36 36 36 36 36 36 36 36 36 36 36 36 39 28 28 28 28 28 28 28
28 28 28 28 28 28 28 34 26 26 26 26 26 26 26 26 26 26 26 26 26 26 26 26 11 11 11 11 11 11 11 11 11 11 11 11 26 26 26 26 26 26 26 26 26 26 26 26 26 26 26 26 26 26 26 26 26 26 26 26 26 26 26 26 26 26 26 26 26 26 26 26 11 11 11 11 11 11 11 11 11 11 11 11 11 11 11 11 11 11 11 11 33 28 28 28 28 28 28 28
28 28 28 28 28 28 28 34 26 12 11 12 11 11 11 11 11 11 11 11 11 26 26 26 26 26 26 26 26 26 26 26 26 26 26 26 26 26 26 26 26 11 11 12 11 11 11 26 26 26 26 26 26 26 26 26 26 26 26 26 26 26 26 26 26 26 26 26 26 26 26 26 11 11 11 11 11 43 11 11 11 11 11 11 11 11 11 11 11 43 11 11 33 28 28 28 28 28 28 28
28 28 28 28 28 28 28 34 26 11 11 11 11 11 30 31 31 31 31 31 32 11 12 26 26 26 26 26 26 26 26 26 26 26 26 26 26 26 26 26 26 26 11 11 11 11 11 11 26 26 26 26 26 26 26 26 26 26 26 26 26 26 26 26 26 26 26 26 26 26 26 26 11 11 11 11 11 11 11 11 11 43 11 11 43 11 11 11 11 11 11 11 33 28 28 28 28 28 28 28
28 28 28 28 28 28 28 34 26 11 26 11 11 11 33 28 28 28 28 29 34 11 11 26 26 26 26 26 26 26 26 26 26 26 26 26 26 26 26 26 26 26 11 11 11 11 11 11 11 11 11 11 11 11 12 26 26 26 26 26 26 26 26 26 26 26 26 26 26 26 26 26 12 11 11 11 11 11 11 11 11 11 11 11 11 11 11 11 11 11 11 11 33 28 28 29 28 28 28 28
28 28 28 28 28 28 28 34 26 26 26 11 11 11 33 28 29 28 28 28 34 11 11 11 26 26 26 26 26 26 26 26 26 26 26 26 26 26 26 26 11 26 11 11 11 26 26 26 26 26 26 26 26 26 11 26 26 26 26 26 26 26 26 26 26 26 26 26 26 26 26 26 11 11 11 43 11 11 11 11 11 11 11 11 11 11 43 11 11 11 11 11 33 28 28 29 28 28 28 28
28 28 28 28 28 28 28 34 26 26 26 11 11 11 33 28 28 28 29 28 34 11 11 11 26 26 26 26 26 26 26 26 26 26 26 26 26 26 26 26 11 26 11 11 26 26 10 10 10 10 10 10 10 10 10 26 26 26 26 26 26 26 26 26 26 26 26 26 26 26 26 26 11 11 11 11 11 11 11 11 43 12 11 11 11 11 11 11 11 11 11 11 33 28 28 28 28 28 28 28
28 28 29 28 28 28 28 34 26 26 26 26 11 11 33 29 28 28 28 28 34 11 11 26 26 26 26 26 26 26 26 26 26 26 26 26 26 26 26 26 11 26 12 11 26 26 10 10 10 10 10 10 10 10 10 26 26 26 26 26 26 26 26 26 26 26 26 26 26 26 26 26 11 11 11 11 11 11 11 11 11 11 11 11 11 11 11 11 11 11 11 11 33 28 28 28 28 28 28 28
28 28 28 28 28 28 28 34 26 26 26 11 11 11 35 36 39 28 38 36 37 11 11 26 26 26 26 26 26 26 26 26 26 26 26 26 26 26 26 26 26 26 11 11 26 26 10 10 10 10 10 10 10 10 10 26 26 26 26 26 26 26 26 26 26 26 26 26 26 26 26 26 11 11 11 11 11 11 11 11 11 11 11 11 11 11 11 11 11 43 11 11 33 28 28 28 28 28 28 28
28 28 28 28 28 28 28 34 26 26 26 26 11 11 11 11 35 36 37 11 11 11 11 26 26 26 26 26 26 26 26 26 26 26 26 26 26 26 26 26 26 26 26 11 26 26 10 10 10 10 10 10 10 10 10 26 26 26 26 26 26 26 26 26 26 26 26 26 26 26 26 26 11 11 43 11 11 11 11 11 11 11 11 11 11 11 11 11 11 11 11 11 33 28 28 28 28 28 28 28
28 28 28 28 28 28 28 34 26 26 26 26 26 11 12 11 11 12 11 11 11 12 11 26 26 26 26 26 26 26 26 26 26 26 26 26 26 26 26 26 26 11 26 26 26 26 10 10 10 10 10 10 10 10 10 26 11 26 11 11 26 26 11 26 11 11 11 11 26 26 11 11 11 11 11 11 11 11 11 11 43 11 11 11 11 43 11 11 11 11 11 11 33 28 28 28 28 28 28 28
28 28 28 28 28 28 28 34 26 26 26 26 26 26 11 11 11 11 11 11 11 11 11 26 26 26 26 26 26 26 26 26 26 26 26 26 26 26 26 26 26 26 26 26 26 26 10 10 10 10 10 10 10 10 10 26 26 26 11 11 26 26 11 26 22 20 20 20 20 20 20 23 11 11 11 43 11 11 11 11 11 11 11 11 11 11 11 11 11 11 11 11 33 28 28 28 28 28 28 28
28 28 28 28 28 28 28 34 26 26 26 26 26 26 26 11 22 20 23 11 26 26 26 26 26 26 26 26 26 26 26 26 26 26 26 26 26 26 26 26 26 11 26 26 26 26 26 26 26 18 13 17 26 26 26 26 26 26 11 11 26 26 26 26 18 13 13 13 13 13 13 17 11 11 11 11 11 11 11 11 11 11 11 11 11 11 11 11 11 11 11 11 33 28 28 28 28 28 28 28
28 29 28 28 28 28 28 34 26 26 26 26 26 26 26 26 18 13 17 26 26 26 26 26 26 26 26 26 26 26 26 26 26 26 26 26 26 26 26 26 26 26 26 26 26 26 26 26 11 18 13 17 26 11 26 26 26 26 26 26 26 26 26 26 18 13 15 15 15 15 15 25 11 11 11 11 11 11 11 11 11 11 43 11 11 11 11 11 11 11 11 11 33 28 28 28 28 28 28 28
28 28 28 28 28 28 28 34 26 26 26 26 26 26 26 26 18 13 17 26 26 26 26 26 26 26 26 26 26 26 26 26 26 26 26 26 26 26 26 26 11 26 26 26 26 26 26 26 11 18 13 17 26 26 26 26 26 26 26 26 26 11 26 26 18 13 17 11 11 26 26 11 11 11 11 43 11 11 11 11 11 11 11 11 11 11 11 11 11 43 11 11 33 28 28 28 28 28 28 28
28 28 28 28 28 28 28 34 26 26 26 11 26 26 26 26 18 13 17 26 26 26 26 26 26 26 26 26 26 26 26 26 26 26 26 26 26 26 26 26 11 26 26 26 26 11 26 26 11 18 13 17 26 26 26 26 26 26 26 26 26 11 26 26 18 13 17 11 11 26 26 11 11 11 11 11 11 11 11 11 11 11 11 11 11 11 11 11 11 11 11 11 33 28 28 28 28 28 28 28
28 28 28 28 28 28 28 34 11 26 26 26 26 26 26 26 18 13 17 26 26 26 26 26 26 26 26 26 26 26 26 26 26 26 26 26 26 26 11 11 11 11 11 11 26 26 26 26 11 18 13 17 26 26 26 11 26 26 11 11 26 11 26 26 18 13 17 11 11 26 11 11 11 11 11 11 11 11 11 11 11 11 11 11 11 11 11 11 11 11 11 11 33 28 28 28 28 28 28 28
28 28 28 28 28 28 28 34 11 11 11 11 11 11 11 11 18 13 17 26 26 26 26 11 11 11 26 11 12 11 11 11 11 26 11 11 11 26 26 26 26 26 26 26 26 26 26 26 11 18 13 17 26 26 26 11 11 26 26 26 26 26 26 26 18 13 17 11 11 26 26 26 26 26 11 11 11 11 26 26 26 11 26 26 11 43 11 11 26 11 11 11 33 28 28 28 28 28 28 28
28 28 28 29 28 28 28 34 11 11 11 11 11 11 12 11 18 13 17 26 26 26 26 26 11 11 11 26 11 11 11 11 11 11 11 26 11 11 11 12 26 26 26 26 11 26 26 26 11 18 13 17 26 11 26 26 26 11 11 26 26 26 26 26 18 13 17 11 26 26 26 26 11 26 26 26 26 26 26 11 26 26 26 26 26 26 11 26 26 26 26 26 33 28 28 28 28 28 28 28
28 28 28 28 28 28 28 34 11 11 12 11 11 11 11 11 18 13 17 26 26 26 26 26 11 12 11 11 11 11 11 11 11 11 26 11 11 26 11 26 26 26 11 26 26 26 26 26 11 18 13 17 26 11 11 11 11 26 26 26 11 26 26 26 18 13 17 26 26 26 26 26 26 26 26 26 26 26 26 26 26 26 26 26 26 26 26 26 26 26 26 26 33 28 28 28 28 29 28 28
28 28 28 28 28 28 28 34 11 11 11 11 11 11 11 11 18 13 17 26 26 26 26 26 26 26 26 26 11 26 26 26 26 26 26 26 26 26 26 26 26 26 26 26 26 26 26 26 26 18 13 17 26 11 11 11 26 26 11 26 11 26 26 26 18 13 17 26 26 26 26 26 26 26 26 26 26 26 26 26 26 26 26 26 26 26 26 26 26 26 11 11 33 28 28 28 28 28 28 28
28 28 28 28 28 28 28 34 11 11 11 11 11 11 11 11 18 13 19 20 20 20 20 20 20 20 20 20 20 20 20 20 20 20 20 20 20 20 20 20 20 20 20 20 20 20 20 20 20 21 13 17 26 26 26 26 26 11 11 26 26 26 26 26 18 13 17 26 26 26 26 26 26 26 26 26 26 26 26 26 26 26 26 26 26 26 26 26 26 26 11 11 33 28 28 28 28 28 28 28
28 28 28 28 28 28 28 34 11 11 11 11 11 11 11 11 18 13 13 13 13 13 13 13 13 13 13 13 13 13 13 13 13 13 13 13 13 13 13 13 13 13 13 13 13 13 13 13 13 13 13 17 26 26 26 26 26 26 26 26 26 26 26 26 18 13 17 26 26 26 26 26 26 26 26 26 26 26 26 26 26 26 26 26 26 26 26 26 26 26 11 11 33 28 28 28 28 28 28 28
28 28 28 28 28 28 28 34 11 11 11 11 12 11 11 11 24 15 15 15 15 15 15 15 15 15 15 15 15 15 15 15 15 15 15 15 15 15 15 15 15 15 15 15 15 15 15 15 15 16 13 17 26 26 26 26 26 26 26 26 26 26 26 26 18 13 17 26 26 26 26 26 26 26 26 26 26 26 26 26 26 26 26 26 26 26 26 26 26 26 11 11 33 28 28 28 28 28 28 28
28 28 29 28 28 28 28 34 11 11 26 11 11 11 11 11 26 26 26 26 26 26 26 26 26 26 26 26 26 26 26 26 26 26 26 26 26 26 26 26 26 26 26 26 26 26 26 26 11 18 13 17 26 26 26 26 26 26 26 26 26 26 26 26 18 13 17 26 26 26 26 26 26 26 26 26 26 26 26 26 26 26 26 26 26 26 26 26 26 26 11 11 35 39 28 28 28 28 28 28
28 28 28 28 28 28 28 34 11 11 26 26 11 11 11 11 26 26 26 26 26 26 26 26 26 26 26 26 26 26 26 26 26 26 26 26 26 26 26 26 26 26 26 26 26 26 26 26 11 18 13 17 26 11 26 26 26 26 26 26 11 26 26 26 18 13 17 26 26 26 26 26 26 26 26 26 26 26 26 26 26 26 26 26 26 26 26 26 26 26 11 11 11 33 28 28 28 28 28 28
28 28 28 28 28 28 28 34 11 11 11 26 26 11 11 11 26 26 26 26 26 26 26 26 26 26 26 26 26 26 26 26 26 26 26 26 26 26 26 26 26 26 26 26 26 26 26 26 11 18 13 17 26 11 26 11 26 26 26 26 26 26 26 26 18 13 17 26 26 26 26 26 26 26 26 26 26 26 26 26 26 26 26 26 26 26 26 26 26 26 11 11 11 33 28 28 28 28 28 28
28 28 28 28 28 28 28 34 11 11 11 11 26 26 11 11 26 26 26 26 26 26 26 26 26 26 26 26 26 26 26 26 26 26 26 26 26 26 26 26 26 26 26 26 26 26 26 26 11 18 13 17 26 26 26 26 26 26 26 26 26 26 26 26 18 13 17 26 26 26 26 26 26 26 26 26 26 26 26 26 26 26 26 26 26 26 26 26 26 26 11 11 11 33 28 28 28 28 28 28
28 28 28 28 28 28 28 34 11 12 11 11 11 26 26 11 26 26 26 26 26 26 26 26 26 26 26 26 26 26 26 26 26 26 26 26 26 26 26 26 26 26 26 26 26 26 26 26 12 18 13 17 26 26 26 26 26 11 26 11 26 26 26 26 18 13 17 26 26 26 26 26 26 26 26 26 26 26 26 26 26 26 26 26 26 26 26 26 26 26 11 11 11 33 28 28 28 28 28 28
28 28 28 28 28 28 28 34 11 11 11 11 11 11 26 26 26 26 26 26 26 26 26 26 26 26 26 26 26 26 26 26 26 26 26 26 26 26 26 26 26 26 26 26 26 26 26 26 11 18 13 17 26 26 26 26 26 26 26 26 26 26 26 26 18 13 17 26 26 26 26 26 26 26 26 26 26 26 26 26 26 26 26 26 26 26 26 26 26 26 11 11 11 33 28 28 28 28 28 28
28 28 28 28 28 28 28 34 11 11 11 11 12 11 11 26 26 26 26 26 26 26 26 26 26 26 26 26 26 26 26 26 26 26 26 26 26 26 26 26 26 26 26 26 26 26 26 26 11 18 13 17 26 26 26 26 26 26 26 26 26 26 26 26 18 13 17 26 26 26 26 26 26 26 26 26 26 26 26 26 26 26 26 26 26 26 26 26 26 26 30 31 31 41 28 28 28 28 28 28
28 28 28 28 28 28 28 34 11 11 11 11 11 11 11 26 26 26 26 26 26 26 26 26 26 26 26 26 26 26 26 26 26 26 26 26 26 26 26 26 26 26 26 26 26 26 26 26 11 18 13 17 26 11 11 26 26 26 26 26 11 26 26 26 18 13 17 26 26 26 26 26 26 26 26 26 26 26 26 26 26 26 26 26 26 26 26 26 26 26 33 28 28 28 28 28 28 28 28 28
28 28 28 28 28 28 28 34 11 11 11 11 11 11 11 26 26 26 26 26 26 26 26 26 26 26 26 26 26 26 26 26 26 26 26 26 26 26 26 26 26 26 26 26 26 26 26 26 11 18 13 17 26 26 26 26 26 26 26 26 11 26 11 26 18 13 17 26 26 26 26 26 26 26 26 26 26 26 26 26 26 26 26 26 26 26 26 26 26 26 33 28 28 28 28 28 29 28 28 28
28 28 28 28 28 28 28 34 11 11 11 11 11 11 11 11 26 26 26 26 26 26 26 26 26 26 26 26 26 26 26 26 26 26 26 26 26 26 26 26 26 26 26 26 26 26 26 26 11 18 13 17 26 26 26 11 11 26 26 26 26 26 11 26 18 13 17 26 26 26 26 26 26 26 26 26 26 26 26 26 26 26 26 26 26 26 26 26 26 26 35 39 28 29 28 28 28 28 28 28
28 28 28 28 28 28 28 34 11 26 26 26 26 26 26 26 26 26 26 26 26 26 26 26 26 26 26 26 26 26 26 26 26 26 26 26 26 26 26 26 26 26 26 26 26 26 26 26 11 18 13 17 26 26 26 26 26 26 26 26 26 26 11 26 18 13 17 26 26 26 26 26 26 26 26 26 26 26 26 26 26 26 26 26 26 26 26 26 26 26 11 33 28 28 28 28 28 28 28 28
28 28 28 28 28 28 28 34 11 26 11 11 26 26 26 11 26 26 26 26 26 26 26 26 26 26 26 26 26 26 26 26 26 26 26 26 26 26 26 26 26 26 26 26 26 26 26 26 11 18 13 17 26 26 11 26 11 26 11 26 26 26 11 26 18 13 17 26 26 26 26 26 26 26 26 26 26 26 26 26 26 26 26 26 26 26 26 26 26 26 11 35 39 28 28 28 28 28 28 28
28 28 28 28 28 28 28 34 26 11 11 26 26 26 26 26 26 26 26 26 26 26 26 26 26 26 26 26 26 26 26 26 26 26 26 26 26 26 26 26 26 26 26 26 26 26 26 26 12 18 13 17 26 26 26 26 26 26 26 26 26 26 26 26 18 13 17 26 26 26 26 26 26 26 26 26 26 26 26 26 26 26 26 26 26 26 26 26 26 26 11 11 33 28 28 28 28 28 28 28
28 28 28 28 28 28 28 34 26 11 26 26 26 11 11 26 26 26 26 26 26 26 26 26 26 26 26 26 26 26 26 26 26 26 26 26 26 26 26 26 26 26 26 26 26 26 26 26 11 18 13 17 26 26 26 26 26 26 26 26 26 26 26 26 18 13 17 26 26 26 26 26 26 26 26 26 26 26 26 26 26 26 26 26 26 26 26 26 26 26 11 11 33 28 28 28 28 28 28 28
28 28 28 28 28 28 28 34 26 26 11 26 26 11 26 26 26 26 26 26 26 26 26 26 26 26 26 26 26 26 26 26 26 26 26 26 26 26 26 26 26 26 26 26 26 26 26 26 11 18 13 17 26 26 26 26 26 26 11 26 26 26 26 26 18 13 17 26 26 26 26 26 26 26 26 26 26 26 26 26 26 26 26 26 26 26 26 26 26 26 11 11 33 28 28 28 28 28 28 28
28 28 28 28 28 28 28 34 11 26 26 26 26 11 26 11 26 26 26 26 26 26 26 26 26 26 26 26 26 26 26 26 26 26 26 26 26 26 26 26 26 26 26 26 26 26 26 26 11 18 13 17 26 11 26 26 26 26 26 26 26 26 26 26 18 13 17 26 26 26 26 26 26 26 26 26 26 26 26 26 26 26 26 26 26 26 26 26 26 26 11 11 33 28 28 28 28 28 28 28
28 28 28 28 28 28 28 34 26 26 11 26 26 26 26 26 26 26 26 26 26 26 26 26 26 26 26 26 26 26 26 26 26 26 26 26 26 26 26 26 26 26 26 26 26 26 26 26 11 18 13 17 26 26 26 11 26 26 26 26 26 26 11 26 18 13 17 26 26 26 26 26 26 26 26 26 26 26 26 26 26 26 26 26 26 26 26 26 26 26 11 11 33 28 28 28 28 28 28 28
28 28 28 28 28 28 28 34 26 11 11 26 26 26 26 26 26 26 26 26 26 26 26 26 26 26 26 26 26 26 26 26 26 26 26 26 26 26 26 26 26 26 26 26 26 26 26 26 11 18 13 17 26 26 26 26 11 26 26 26 26 26 26 26 18 13 17 26 26 26 26 26 26 26 26 26 26 26 26 26 26 26 26 26 26 26 26 26 26 26 11 11 33 28 28 28 28 28 28 28
28 28 28 28 28 28 28 34 26 26 26 26 26 26 26 26 26 26 26 26 26 26 26 26 26 11 26 26 26 26 26 26 26 11 11 11 11 11 11 11 11 12 11 11 11 11 11 11 22 21 13 19 23 26 26 26 26 26 26 26 26 26 26 26 18 13 17 26 26 26 26 26 26 26 26 26 26 26 26 26 26 26 26 26 26 26 26 26 26 26 11 11 33 28 28 28 28 28 28 28
28 28 28 28 28 28 28 34 26 26 26 26 26 26 26 26 26 26 26 26 26 26 26 26 26 11 26 11 26 26 26 20 20 20 20 20 20 20 20 20 20 20 20 20 20 20 20 20 21 13 13 13 19 20 20 20 20 20 20 20 20 20 20 20 21 13 17 26 26 26 26 26 26 26 26 26 26 26 26 26 26 26 26 26 26 26 26 26 26 26 11 11 33 28 28 28 28 28 28 28
28 28 28 28 28 28 28 34 26 26 26 26 26 26 26 26 26 26 26 26 26 26 26 26 26 26 26 26 26 11 26 13 13 13 13 13 13 13 13 13 13 13 13 13 13 13 13 13 13 13 13 13 13 13 13 13 13 13 13 13 13 13 13 13 13 13 17 26 26 26 26 26 26 26 26 26 26 26 26 26 26 26 26 26 26 26 26 26 26 26 11 11 33 28 28 28 28 28 28 28
28 28 28 28 28 28 28 34 26 26 26 26 26 26 26 26 26 26 26 26 26 26 26 26 26 26 26 26 26 26 26 15 15 15 15 15 15 15 15 15 15 15 15 15 15 15 15 15 16 13 13 13 14 15 15 15 15 15 15 15 15 15 15 15 15 15 25 26 26 26 26 26 26 26 26 26 11 11 11 11 11 11 11 26 11 11 26 26 26 26 26 26 33 28 28 28 28 28 28 28
28 28 28 28 28 28 28 34 26 26 26 26 11 26 26 26 26 26 26 26 26 26 26 26 11 26 26 26 26 26 26 26 26 26 26 26 26 26 26 26 26 26 26 26 26 26 26 26 24 16 13 14 25 11 11 11 11 11 26 26 26 26 26 26 26 26 26 26 26 26 26 26 26 26 26 26 26 26 26 26 26 26 26 26 26 26 26 26 26 26 26 26 33 28 28 28 28 28 28 28
28 28 28 28 28 28 28 34 26 11 26 26 26 26 26 26 26 26 26 26 26 26 26 26 26 26 26 26 26 26 26 26 26 26 26 26 26 26 26 26 26 26 26 26 26 26 26 26 26 18 13 17 11 11 11 11 11 11 11 11 11 11 11 26 26 26 26 26 26 26 26 26 26 26 26 26 26 26 26 26 26 11 26 26 26 26 26 26 26 26 11 26 33 28 28 28 29 28 28 28
28 28 28 28 28 28 28 34 26 11 26 26 26 26 26 26 26 26 26 26 26 26 26 26 26 26 26 26 26 26 26 26 26 26 26 26 26 26 26 26 26 26 26 26 26 26 26 26 26 18 13 17 26 26 26 26 26 26 26 26 26 26 11 11 26 26 26 26 26 26 26 26 26 26 26 26 26 26 26 26 26 26 26 11 26 26 11 11 11 26 11 26 33 28 28 28 28 28 28 28
28 28 29 28 28 28 28 34 26 26 26 11 26 26 26 26 26 26 26 26 26 26 26 26 26 26 26 26 26 26 26 26 26 26 26 26 26 26 26 26 26 26 26 26 26 26 26 26 26 18 13 17 26 26 26 26 26 26 26 26 26 26 26 11 11 11 11 26 26 26 26 26 26 26 11 11 26 26 26 11 26 11 26 26 26 26 26 26 11 26 26 26 33 28 28 28 28 28 28 28
28 28 28 28 28 28 28 34 26 26 26 26 26 26 26 26 26 26 26 26 26 26 26 26 26 26 26 26 11 11 11 11 26 26 26 26 26 26 26 26 26 26 26 26 26 26 26 26 26 18 13 17 26 26 26 26 26 26 26 26 26 26 26 26 26 26 11 26 26 26 26 26 26 26 26 11 11 26 26 26 26 26 11 11 11 26 26 11 26 26 26 26 33 28 28 28 28 28 28 28
28 28 28 28 28 28 28 34 26 26 26 11 26 26 26 26 26 26 26 26 26 26 26 26 26 26 26 26 26 26 26 26 26 26 26 26 26 26 26 26 26 26 26 26 26 26 26 26 26 18 13 17 26 26 26 26 26 26 26 26 26 26 26 26 26 26 11 11 11 11 26 26 26 26 26 26 26 26 26 26 11 26 26 26 26 26 26 26 26 26 26 26 33 28 28 28 28 28 28 28
28 28 28 28 28 28 28 34 26 11 26 26 26 26 26 26 26 26 26 26 26 26 26 26 26 26 26 26 26 26 26 26 26 26 26 26 26 26 26 26 26 26 26 26 26 26 26 26 26 18 13 17 26 26 26 26 26 26 26 26 26 26 26 26 11 11 11 11 11 11 11 26 26 26 26 26 26 26 26 11 11 11 11 11 11 11 26 26 11 26 26 26 33 28 28 28 28 28 29 28
28 28 29 28 28 28 28 34 26 26 26 26 26 26 26 26 26 26 26 26 26 26 26 26 26 26 26 26 26 11 11 11 26 26 26 26 26 26 26 26 26 26 26 26 26 26 26 26 26 18 13 17 26 26 26 26 26 26 26 26 26 26 26 26 11 11 11 11 11 11 11 11 26 26 26 11 26 26 26 26 27 27 27 27 27 27 27 27 27 27 11 26 33 28 28 28 28 28 28 28
28 28 28 28 29 28 28 34 11 11 26 26 26 26 26 26 26 26 26 26 26 26 26 26 26 26 26 26 26 26 26 26 26 26 26 26 26 26 26 26 26 26 26 26 26 26 26 26 26 18 13 17 26 26 26 26 26 26 26 26 26 26 26 26 11 11 11 12 11 11 11 11 26 26 26 26 26 26 26 11 27 11 11 11 11 11 11 27 27 27 11 26 33 28 28 28 28 28 28 28
28 28 28 28 28 28 28 34 11 26 11 26 26 26 26 26 26 26 26 26 26 26 26 26 26 26 26 26 26 26 26 26 26 26 26 26 26 26 26 26 26 26 26 26 26 26 26 26 26 18 13 17 26 26 26 26 26 26 26 26 26 26 26 26 11 11 11 11 11 11 12 11 26 26 26 11 26 26 26 11 27 11 27 27 27 27 27 27 11 11 11 26 33 28 28 28 28 28 28 28
28 28 28 28 28 28 28 34 11 26 26 26 11 11 26 26 11 26 11 26 11 26 26 26 26 26 26 26 26 26 26 26 26 26 26 26 26 26 26 26 26 26 26 26 26 26 26 26 26 18 13 17 26 26 26 26 26 26 26 26 26 26 26 26 11 11 11 11 11 11 11 26 26 26 11 11 26 26 26 11 27 11 27 11 11 11 11 11 11 11 11 11 33 28 28 28 28 28 28 28
28 28 28 28 28 28 28 34 11 11 26 26 26 26 11 26 26 26 26 26 26 26 26 11 26 26 26 26 26 26 26 26 26 26 26 26 26 26 26 26 26 26 26 26 26 26 26 26 26 18 13 17 26 26 26 26 26 26 26 26 26 26 26 26 26 26 26 26 26 26 26 26 26 26 26 26 26 11 26 11 27 11 27 27 27 27 27 27 27 27 27 11 33 28 28 28 28 28 28 28
28 28 28 28 28 28 28 34 11 11 11 26 11 11 26 11 26 26 26 26 11 11 11 26 26 26 26 11 26 26 26 26 26 26 26 26 26 26 26 26 26 26 26 26 26 26 26 26 26 18 13 17 26 26 26 26 26 26 26 26 26 26 26 26 26 26 26 26 26 26 26 26 26 26 26 26 26 26 26 11 27 11 11 11 11 11 11 11 11 11 27 11 33 28 28 28 28 28 28 28
28 29 28 28 28 28 28 34 11 11 11 26 26 11 26 11 11 26 26 11 26 26 26 26 11 26 26 26 26 26 26 26 26 26 26 26 26 26 26 26 26 26 26 26 26 26 26 26 26 18 13 17 26 26 26 26 26 26 26 26 26 26 26 26 26 26 26 26 26 26 26 26 26 26 26 26 26 26 26 26 27 11 11 27 11 27 27 27 27 27 27 11 33 28 28 29 28 28 28 28
28 28 28 28 28 28 28 34 12 11 11 11 26 26 26 26 11 26 11 11 11 11 11 11 11 11 11 11 26 26 26 26 26 26 26 26 26 26 26 26 26 26 26 26 26 26 26 26 26 18 13 17 26 26 26 26 26 26 26 26 26 26 26 26 26 26 26 26 26 26 26 26 26 26 26 26 26 26 26 26 27 11 11 27 11 27 11 11 11 11 11 11 33 28 28 28 28 28 28 28
28 28 28 28 28 28 28 34 11 11 11 26 26 26 11 26 26 26 26 26 26 26 26 11 11 11 11 11 26 26 26 26 26 26 26 26 26 26 26 26 26 26 26 26 26 26 26 26 26 18 13 17 26 26 26 26 26 26 26 26 26 26 26 26 26 26 26 26 26 26 26 26 26 26 26 26 26 26 26 11 27 11 11 27 11 27 11 27 27 27 27 11 33 28 28 28 28 28 28 28
28 28 28 28 28 28 28 34 11 11 11 26 26 26 26 26 26 26 26 26 26 26 26 26 26 26 26 26 26 26 26 26 26 26 26 26 26 26 26 26 26 26 26 26 26 26 26 26 26 18 13 17 26 26 26 26 26 26 26 26 26 26 26 26 26 26 26 26 26 26 26 26 26 26 26 26 26 26 26 11 27 11 11 27 11 27 11 27 11 11 27 11 33 28 28 28 28 28 28 28
28 28 28 28 28 28 28 34 11 11 11 11 11 26 26 11 26 11 26 11 11 11 11 12 11 11 11 11 11 22 20 20 20 20 20 20 20 20 20 20 20 20 20 20 20 20 20 20 20 21 13 17 26 26 26 26 26 26 26 26 26 26 26 26 26 26 26 26 26 26 26 26 26 26 26 26 26 26 26 11 27 11 11 27 11 27 11 27 11 11 27 11 33 28 28 28 28 28 28 28
28 28 28 28 28 28 28 34 11 11 11 11 11 11 11 26 26 26 26 11 11 11 11 11 11 11 11 11 11 18 13 13 13 13 13 13 13 13 13 13 13 13 13 13 13 13 13 13 13 13 13 17 26 26 26 26 26 26 26 26 26 26 26 26 26 26 26 26 26 26 26 26 26 26 26 26 26 26 26 11 27 11 11 27 11 27 27 27 11 11 27 11 33 28 28 28 28 28 28 29
28 28 28 28 28 28 28 34 11 12 11 11 12 11 11 11 11 26 26 11 11 12 11 11 11 12 11 11 11 24 15 15 15 15 15 15 15 15 15 15 15 15 15 15 15 15 15 15 15 16 13 17 11 11 11 11 11 11 26 26 26 26 26 26 26 26 26 26 26 26 26 26 26 26 26 26 26 26 26 11 11 11 11 27 11 11 11 11 11 11 27 11 33 28 28 28 28 28 28 28
28 28 28 28 28 28 28 34 11 11 11 11 11 11 11 11 11 11 26 11 11 11 11 11 11 11 11 11 11 11 26 26 26 26 26 26 26 26 26 26 26 26 26 26 26 26 11 11 26 18 13 17 26 26 26 26 26 26 26 26 26 26 26 26 26 26 26 26 26 26 26 26 26 26 26 26 26 26 26 11 27 27 27 27 27 27 27 27 27 27 27 11 33 28 28 28 28 28 28 28
28 28 28 28 28 28 28 34 11 11 11 11 11 11 11 11 11 11 11 11 11 11 11 11 11 11 11 11 26 26 26 11 11 11 11 11 11 11 11 26 26 26 26 26 26 26 26 26 26 18 13 17 26 26 26 26 26 26 26 26 26 26 26 26 26 26 26 26 26 26 26 26 26 26 26 26 26 26 26 26 26 26 26 26 26 26 26 26 11 11 11 11 33 28 28 28 28 28 28 28
28 28 29 28 28 28 28 34 11 11 11 11 11 11 26 11 26 26 26 26 26 26 26 26 26 26 26 26 26 11 26 11 11 11 26 26 26 26 26 26 26 26 11 11 26 26 26 26 26 18 13 17 26 26 26 26 26 26 26 26 26 26 26 26 26 26 26 26 26 26 26 26 26 26 26 26 26 26 26 26 26 26 26 26 26 11 11 26 26 26 26 11 33 28 28 28 28 28 28 28
28 28 28 28 28 28 28 34 11 11 11 11 11 11 26 11 26 26 11 26 26 26 26 26 26 26 11 11 26 26 26 26 26 26 26 26 26 26 26 11 26 11 26 11 26 26 26 26 26 18 13 17 26 26 26 26 26 26 26 26 26 26 26 26 26 26 26 26 26 26 26 26 26 26 26 26 26 26 26 26 11 11 11 11 26 26 26 26 26 26 26 11 33 28 28 28 28 28 28 28
28 28 28 28 28 28 28 34 11 12 11 11 11 11 26 26 11 26 26 26 26 26 26 26 26 26 26 26 26 26 26 26 26 26 11 11 11 26 11 26 26 11 26 11 26 26 26 26 26 18 13 17 26 26 26 26 26 26 26 26 26 26 26 26 26 26 26 26 26 26 26 26 26 26 26 26 26 26 26 26 26 26 26 26 26 26 26 26 26 26 11 11 33 28 28 28 28 29 28 28
28 28 28 28 28 28 28 34 11 11 11 11 11 11 26 26 26 26 26 26 11 11 26 26 26 26 26 26 11 11 11 26 26 26 26 26 26 26 26 26 26 26 26 26 26 11 26 26 26 18 13 17 26 26 26 26 26 30 31 31 31 31 31 31 31 31 31 31 31 31 32 26 26 26 26 26 26 26 26 26 26 26 26 26 26 26 26 26 26 26 26 26 33 28 28 28 28 28 28 28
28 28 28 28 28 28 28 34 11 11 11 11 11 11 11 26 26 26 26 26 26 11 11 26 26 26 26 26 26 26 26 26 26 26 26 26 26 26 26 26 26 26 11 26 26 26 26 26 26 18 13 17 26 26 26 26 26 33 28 28 28 28 28 28 28 29 28 28 28 28 34 26 26 26 26 26 26 26 26 26 26 26 26 26 26 26 26 26 26 26 26 26 33 28 28 28 28 28 28 28
28 28 28 28 28 28 38 37 11 11 11 11 11 11 26 26 26 26 26 11 26 26 26 26 26 11 26 26 26 26 26 26 26 11 11 11 11 26 26 26 11 26 26 26 26 26 26 26 26 18 13 17 26 26 26 26 26 33 28 28 28 28 28 28 28 28 28 28 28 28 34 26 26 26 26 26 26 26 26 26 26 26 26 26 26 26 26 26 26 26 26 26 33 28 28 28 28 28 28 28
28 28 28 28 28 28 34 11 11 11 11 11 11 11 26 26 26 11 26 26 26 26 26 11 26 26 11 26 11 26 26 11 26 26 26 26 26 26 26 26 26 26 11 11 26 26 26 11 26 18 13 17 26 26 26 26 26 33 28 38 39 29 28 28 28 28 28 28 28 29 34 26 26 26 26 26 26 26 26 26 26 26 26 26 26 26 26 26 26 26 26 26 33 28 28 29 28 28 28 28
28 28 28 28 28 28 34 11 11 11 11 11 11 26 26 26 26 26 26 26 26 11 26 26 26 11 26 26 11 26 26 26 26 26 26 11 11 11 11 26 26 26 26 26 26 26 12 11 26 18 13 17 26 26 26 26 26 33 28 40 41 28 28 28 28 38 36 36 39 28 34 26 26 26 26 26 26 26 26 26 26 26 26 26 26 26 26 26 26 26 26 26 33 28 28 28 28 28 28 28
28 28 28 28 28 28 40 31 32 11 26 26 11 26 11 26 26 26 11 26 26 26 26 26 11 11 26 26 26 26 26 11 11 26 26 26 26 11 26 26 26 26 26 26 11 26 26 26 26 18 13 17 26 26 26 26 26 33 28 28 28 28 28 28 28 34 22 23 33 28 34 26 26 26 26 26 26 26 26 26 26 26 26 26 26 26 26 26 26 26 26 26 33 28 28 28 28 28 28 28
28 28 28 28 29 28 28 28 34 11 11 11 26 26 26 26 26 26 26 26 26 11 26 11 11 11 26 26 26 11 26 11 11 26 11 26 26 11 26 26 26 26 26 11 11 11 22 20 20 21 13 17 26 26 26 26 26 33 29 28 28 28 28 28 28 34 18 17 33 28 34 26 26 26 26 26 26 26 26 26 26 26 26 26 26 26 26 26 26 26 26 26 33 28 28 28 28 28 28 28
28 28 28 28 28 28 28 28 34 11 11 11 11 26 26 26 26 26 26 26 26 26 26 26 26 26 26 26 11 11 11 11 26 26 11 26 26 26 11 11 26 26 26 26 26 11 18 13 13 13 13 17 26 26 26 26 26 33 28 28 28 28 28 29 28 34 18 17 33 28 34 26 26 26 26 26 26 26 26 26 26 26 26 26 26 26 26 26 26 26 26 26 33 28 28 28 28 28 28 28
28 28 28 28 28 28 28 28 34 11 11 11 11 11 11 11 26 11 11 26 11 26 26 26 11 11 11 11 26 26 26 26 11 26 26 11 26 26 26 26 11 11 26 26 26 11 18 13 14 15 15 25 26 26 26 26 26 35 36 36 36 36 36 36 36 37 18 17 35 36 37 26 26 26 26 26 26 26 26 26 26 26 26 26 26 26 26 26 26 26 26 26 33 28 28 28 28 28 28 28
28 28 28 28 28 28 28 28 34 11 11 11 11 11 12 11 11 26 11 11 11 26 11 11 12 26 11 11 12 11 26 11 11 11 11 11 26 11 11 26 26 11 26 26 26 22 21 13 19 23 26 26 26 26 26 26 26 26 26 12 43 11 11 12 26 11 24 25 11 26 26 26 26 26 11 26 26 26 26 26 26 26 26 26 11 26 26 11 26 11 11 11 33 28 28 28 28 28 29 28
28 28 28 28 28 28 28 28 34 11 11 11 11 11 11 11 11 26 11 11 26 26 11 11 11 26 26 11 11 26 26 11 11 11 12 11 11 26 26 26 26 26 26 26 26 18 13 13 13 17 26 26 26 26 26 26 26 26 26 22 20 20 20 20 20 20 23 12 26 26 26 26 26 26 26 26 26 26 26 26 11 11 26 26 26 26 26 26 26 12 11 11 33 28 28 28 28 28 28 28
28 28 29 28 28 28 28 28 34 11 11 11 11 11 11 11 11 26 26 26 11 11 11 11 11 11 26 26 26 26 26 11 11 11 11 11 11 11 11 11 11 26 11 26 26 18 13 13 13 17 26 26 26 26 26 26 26 26 26 24 15 15 15 15 15 15 25 11 11 12 26 26 26 26 11 11 11 11 26 26 26 26 12 11 26 26 26 26 26 11 11 11 33 28 28 28 28 28 28 28
28 28 28 28 28 28 28 28 34 11 11 12 11 11 11 11 11 11 26 11 11 11 11 11 11 11 11 11 11 11 26 11 26 26 26 11 11 11 11 11 26 26 11 11 11 18 13 13 13 17 26 26 26 26 26 26 26 26 26 11 11 26 12 11 26 12 26 26 11 11 11 11 26 26 26 26 26 26 26 11 26 26 11 11 11 26 26 26 11 11 11 11 33 28 28 28 28 28 28 28
28 28 28 28 28 28 28 28 34 11 11 11 11 11 11 11 11 11 11 11 11 11 11 11 11 11 11 11 11 11 26 26 26 11 26 26 26 26 26 26 11 11 11 11 11 18 13 13 13 17 26 26 26 26 26 26 26 26 26 26 26 26 26 26 26 26 26 26 26 26 26 11 26 11 11 11 11 11 11 11 26 11 11 11 11 11 11 11 11 11 11 11 33 28 28 28 28 28 28 28
28 28 28 28 28 28 28 28 34 11 11 11 11 11 11 11 11 11 11 11 11 11 11 30 31 32 11 11 11 11 11 11 22 20 20 20 20 20 20 20 20 20 20 20 20 21 13 13 13 19 20 20 20 20 20 20 20 20 20 20 20 20 20 20 20 23 11 11 11 11 11 12 11 11 11 11 11 11 11 11 12 11 11 11 11 12 11 11 11 12 11 11 33 28 28 28 28 28 28 28
28 28 28 28 28 28 28 28 40 32 11 11 11 11 11 11 11 11 12 11 11 30 31 41 28 34 11 11 11 11 11 11 24 15 15 15 15 15 15 15 15 15 15 15 15 15 15 15 15 15 15 15 15 15 15 15 15 15 15 15 15 15 15 15 15 25 11 11 11 11 11 11 11 11 11 11 11 11 11 11 11 11 11 11 11 11 11 11 11 11 11 11 35 39 28 28 28 28 28 28
28 28 28 28 28 28 28 28 28 40 31 31 31 31 31 31 31 31 31 31 31 41 28 28 28 40 31 31 31 31 31 31 31 31 31 31 31 31 31 31 31 31 31 31 31 31 31 31 31 31 31 31 31 31 31 31 31 31 31 31 31 31 31 31 31 31 31 31 31 31 31 31 31 31 31 31 31 31 31 31 31 31 31 31 31 31 31 31 31 31 31 31 31 41 28 28 28 28 28 28
28 28 28 28 28 28 28 28 28 28 28 28 28 28 28 28 28 28 28 28 28 28 28 28 28 28 28 28 28 28 28 28 28 28 28 28 28 28 28 28 28 28 28 28 28 28 28 28 28 28 28 28 28 28 28 28 28 28 28 28 28 28 28 28 28 28 28 28 28 28 28 28 28 28 28 28 28 28 28 28 28 28 28 28 28 28 28 28 28 28 28 28 28 28 28 28 28 28 28 28
28 28 28 28 28 28 28 28 28 28 28 28 28 28 28 28 28 28 28 28 28 28 28 28 28 28 28 28 28 28 28 28 28 28 28 28 28 29 28 28 28 28 28 28 28 28 28 28 29 28 28 28 28 28 28 28 28 28 28 28 28 28 28 29 29 28 28 28 28 28 28 28 28 28 28 28 28 28 28 28 28 28 28 28 28 28 28 28 28 28 28 28 28 28 28 28 28 28 28 28
28 28 28 28 29 28 28 28 28 28 28 28 28 28 28 28 28 28 28 28 28 28 28 29 28 28 28 28 28 28 28 28 28 28 28 28 28 29 28 28 28 28 28 28 28 28 28 28 28 28 28 28 28 28 28 29 28 28 28 28 28 28 28 28 28 28 28 28 28 28 28 28 28 28 28 28 28 28 29 28 28 28 28 28 28 28 28 28 28 28 29 28 28 28 28 28 28 28 28 28
28 28 28 28 28 28 28 28 28 28 28 28 28 28 28 28 28 28 28 29 28 28 28 28 28 28 28 28 28 28 28 28 28 28 28 28 28 28 28 28 28 28 28 28 28 28 28 28 28 28 28 28 28 28 28 28 28 28 28 28 29 28 28 38 39 28 28 29 28 28 28 28 28 28 28 28 28 28 28 28 28 28 28 28 28 28 28 28 28 28 28 28 28 28 28 28 28 29 28 28
28 28 28 28 28 28 28 28 28 28 28 28 28 28 28 28 28 28 28 28 28 28 28 28 28 28 28 28 28 28 28 28 28 28 28 28 28 28 28 28 28 28 28 28 28 28 28 28 28 28 28 28 28 28 28 28 28 28 28 28 28 28 28 40 41 28 28 28 28 28 28 28 28 28 28 28 28 28 28 28 28 28 28 28 28 28 28 28 28 28 28 28 28 28 28 28 28 28 28 28
28 28 28 28 28 28 28 28 28 28 28 28 28 28 28 28 28 28 28 28 28 28 28 28 28 28 28 29 28 28 28 28 28 28 28 28 28 28 28 28 28 28 28 28 29 28 28 28 28 28 28 28 28 28 28 28 28 28 28 28 28 28 28 28 28 28 28 28 28 28 28 28 28 28 28 28 28 28 28 28 28 28 28 28 28 28 28 28 28 28 28 28 28 28 28 28 28 28 28 28